Bv Bv Bv Bv Bv dv Dv Dv Dv d<
ov ov ov ov ov ov ov ov ov D<
ov ov Sv Sv Sv Sv Sv ov ov d<
Ov ov ov ov ov ov ov ov ov d<
C> ov ov ov r^ r^ ov ov ov d<
V> ov ov ov Rv Rv ov ov ov M<
V> ov ov ov ov ov ov ov ov M<
V> ov ov ov ov ov ov ov ov M<
V> ov ov ov ov ov ov ov ov M<
vv V^ V^ V^ V^ m^ m^ m^ M^ m^