B o B B o o d d D d
B o o o o o o o o D
o o B S S S o o o d
o o o o o o o o o d
C o o o r r o o o o
o o o o R R o o o M
o o o o o o o o o M
o o o o o o o o o M
o o o o o o o o o M
V V V V V m m m m m